XXXXXXXXXXXXXXXXXXXXXXXXXXXXXX
XOOOOOOOOOOOOOOOOOOOOOOOOOOOX
XOXOXOXOXOXOXOXOXOXOXOXOXOXOX
XOOOOOOOOOOOOOOOOOOOOOOOOOOOX
XOXOXOXOXOXOXOXOXOXOXOXOXOXOX
XOOOOOOOOOOOOOOOOOOOOOOOOOOOX
XOXOXOXOXOXOXOXOXOXOXOXOXOXOX
XOOOOOOOOOOOOOOOOOOOOOOOOOOOX
XOXOXOXOXOXOXOXOXOXOXOXOXOXOX
XOOOOOOOOOOOOOOOOOOOOOOOOOOOX
XOXOXOXOXOXOXOXOXOXOXOXOXOXOX
XOOOOOOOOOOOOOOOOOOOOOOOOOOOX
XOXOXOXOXOXOXOXOXOXOXOXOXOXOX
XOOOOOOOOOOOOOOOOOOOOOOOOOOOX
XXXXXXXXXXXXXXXXXXXXXXXXXXXXXX
